H0000000H00000000000H0
0000000000000000000000
0011001100110011001100
0011001100110011001100
0011001100110011001100
0011001100110011001100
0011001100110011001100
0011000000000000001100
0011000000000000001100
00000011B011B011000000
0000001100110011000000
11000000000000000000B0
1100000000000000000000
4400001111111111000044
0000001111111111000000
0011001100110011001100
0011001100110011001100
0011000000000000001100
0000000000000000000000
0000000000110000000000
000000P011E01100000000
0000000011001100000000

3
2
1




