0000000000000000000000
0000000000000000000000
1111000000000000001111
1111000000000000001111
0000000111111110000000
0000000110000110000000
1110000110000110000111
0011000000000000001100
0011000000000000001100
0000001100110011000000
0000001100110011000000
1100000000000000000011
1100000000000000000011
0000001111111111000000
0000001111111111000000
0011004444444444001100
0011000000000000001100
0011000000000000001100
0000000000000000000000
0000000000110000000000
000000P011E01100000000
0000000011001100000000

3
4
3




